PPPPPPPPPPPPPPPPPPPPPPPP
P                   M  P
P    M                 P
P         P            P
PPPPPPPPPPP            P
P                      P
P         PPPPPPPPPPPPPP
P      V       J       P
P                      P
P           P          P
P   M       P   M      P
P           PPPPPPPPPPPP
P                      P
P            E         P
P V                    P
PPPPPPPPPPPPPPPPPPPPPPPP