PPPPPPPPPPPPPPPPPPPPPPPP
P                      P
P              P       P
P              P       P
P       M    V P       P
P          PPPPP       P
P                 M    P
P              M       P
P                      P
P           P          P
P   M       P          P
P         E P          P
P  PPPPPPPPPP          P
P            J         P
P   M                  P
PPPPPPPPPPPPPPPPPPPPPPPP