M                M      
           J            
       P       P E      
       P       P        
  V    P       P P   V  
       P       P P      
       P       P P      
   M        M         M 
            V           
       P P     P        
       P P     P   M    
       P P     P   M M  
       P P     P        
       P P     P PPPPP  
  M       M             
                        