J                       
PPPPP        PPPP       
V   P               P   
    P      M        P V 
M   P   M           PPP 
                        
    M         PPPPP     
      P       P M       
     P        PPPP      
    P           E P     
               PPPP     
PPPPPPPPPPPPPPP         
                        
M       M      PVP      
               PPP      
PPPPPPPPPPPPPPPPPP      